wwwwwwwwwww
wwwwwwwwwww
w    p    w         
w---------w
w---------w
w----*----w      
w---------w      
w---------w        
w--------*w       
w---------w       
w---------w       
w*--------w         
w---------w        
w----*----w         
w---------w         
w---------w         
wwwww&wwwww